############################
#O...........##...........O#
#.####.#####.##.#####.####.#
#.####.#####.##.#####.####.#
#.####.#####.##.#####.####.#
#..........................#
#.####.##.########.##.####.#
#.####.##.########.##.####.#
#......##....##....##......#
######.##### ## #####.######
     #.##..........##.#     
     #.##.###..###.##.#     
     #.##. GGGG .##.#     
######.##.######.##.######
      . ....P... .      
######.##.######.##.######
     #.##..........##.#     
     #.##.########.##.#     
######.##.########.##.######
#............##............#
#.####.#####.##.#####.####.#
#.####.#####.##.#####.####.#
#O..##................##..O#
###.##.##.########.##.##.###
###.##.##.########.##.##.###
#......##....##....##......#
#.##########.##.##########.#
#.##########.##.##########.#
#..........................#
############################